康瑜	东南大学	江苏	南京
李沁怡	复旦大学	上海	上海
韩熠星	浙江大学	浙江	杭州
刘非迟	同济大学	上海	上海
戴汉宸	中央财经大学	北京	北京
李明翰	中央民族大学	北京	北京
雒洛	上海交通大学	上海	上海
梅逸云	中山大学	广东	广州
马旭骋	上海交通大学	上海	上海
杨逸凡	厦门大学	福建	厦门
柴沛霖	清华大学	北京	北京
刘雷	北京航空航天大学	北京	北京
骆浩毅	武汉大学	湖北	武汉
李昊	武汉大学	湖北	武汉
金子天	北京航空航天大学	北京	北京
董昕瑜	香港大学	香港	香港
刘舜威	厦门大学	福建	厦门
周清原	清华大学	北京	北京
魏乐颖	北京邮电大学	北京	北京
孙柏扬	北京理工大学	北京	北京
王冠杰	浙江大学	浙江	杭州
任诗雨	对外经济贸易大学	河北	北京
李金洋	同济大学	上海	上海
蔺立萱	北京航空航天大学	北京	北京
古丽娜	清华大学	北京	北京
张钊	武汉大学	湖北	武汉
李哲昀	复旦大学	上海	上海
刘浩然	清华大学	北京	北京
陈卓文	四川大学	四川	成都
陈颖婕	北京大学	北京	北京
郑瑜	清华大学	北京	北京
闫婷钰	同济大学	上海	上海
郝亦雯	同济大学	上海	上海
胡焘	同济大学	上海	上海
靳健	同济大学	上海	上海
聂昭颖	清华大学	北京	北京
邓琮之	中国科学技术大学	安徽	合肥
孙浩	南京航空航天大学	江苏	南京
陈亚舟	清华大学	北京	北京
杨晓睿	上海财经大学	上海	上海
陈成	同济大学	上海	上海
王雅清	上海财经大学	上海	上海
黄宇秋	上海交通大学	上海	上海
赵泽宇	中央财经大学	北京	北京
金泽宇	北京交通大学	北京	北京
刘霄旸	北京师范大学	北京	北京
胡翊	对外经济贸易大学	北京	北京
周春晖	北京第二外国语学院	北京	北京
李聪	哈尔滨工业大学	黑龙江	哈尔滨
张志远	华东政法大学	上海	上海
徐新鑫	同济大学	上海	上海
田桑瑜	同济大学	上海	上海
孟菀芸	四川大学	四川	成都
王子烈	北京航空航天大学	北京	北京
许宜臻	南京大学	江苏	南京
严梓夫	华南理工大学	广东	广州
杨松涛	中国石油大学	北京	北京
方德治 佐治亚理工学院 美国 亚特兰大
吕梦帆 布兰迪斯大学 美国 波士顿